!!!                            @@@       !! aaaaa$$$
!!   D             B   B      @@@       C !!  aaa $$
!           aa aaa   B      @@@  D   aa    !   Eaa $
           cc  c aaa        @@bb D   aaa           $
              ccc aaa        bb              A
!!!!!            aaa                   !!   A    aaa
!!!!!!!          A         @@        !!!!!!   ccc  $
!!!!!!!!!!              cc @@@       !!!!!!! cc   $$
!!!!!!!!!    E   B   C  ccc @@@     bb !!!!!!     $$
!!!!!!!!    E          B bbbb @@     bb !!!!!!   $$$